11111111111
1P00C000001
10110000001
10000000001
11111000001
1010C001001
1000E000011
1C000000011
11111111111