111111111
100000011
1P100E1C1
100001111
111111111